Bhanjanagar	India
Bhānder	India
Bhandāra	India
Bhālki	India
Bhaisa	India
Bhainsdehi	India
Bhāgalpur	India
Bhadreswar	India
Bhadrāvati	India
Bhadrakh	India
Bhadrāchalam	India
Bhādra	India
Bhadohi	India
Bhadaur	India
Bhādāsar	India
Bhachāu	India
Bhabhua	India
Beypore	India
Bewar	India
Betūl	India
Bettiah	India
Betamcherla	India
Beri Khās	India
Berasia	India
Beohāri	India
Bemetāra	India
Belūr	India
Belsand	India
Belonia	India
Bellary	India
Belgaum	India
Beldānga	India
Bela	India
Behror	India
Behat	India
Begusarai	India
Begūn	India
Begamganj	India
Bedi	India
Beāwar	India
Bāzpur	India
Bayāna	India
Bawāna	India
Bauda	India
Batāla	India
Baswa	India
Bāsudebpur	India
Bastī	India
Bāsoda	India
Basni	India
Basmat	India
Basi	India
Basi	India
Basi	India
Basavana Bāgevādi	India
Basavakalyān	India
Barwāni	India
Barwāla	India
Bāruni	India
Bāruipur	India
Bārsi	India
Barpeta	India
Barpāli	India
Barnāla	India
Bārmer	India
Barki Saria	India
Barka Kāna	India
Barjala	India
Bari Sādri	India
Bāri	India
Barhiya	India
Bārh	India
Bargi	India
Bargarh	India
Bareilly	India
Bārdoli	India
Barddhamān	India
Bar Bigha	India
Baraut	India
Barauli	India
Bārāsat	India
Bārāsat	India
Baranagar	India
Bārān	India
Bāramūla	India
Bārāmati	India
Bārākpur	India
Bāpatla	India
Banūr	India
Bantvāl	India
Bāntva	India
Bānswāra	India
Bānswāda	India
Bānsi	India
Bānsdīh	India
Bānsbāria	India
Bannūr	India
Banmankhi	India
Bānkura	India
Bānki	India
Bānka	India
Bāngarmau	India
Bangārapet	India
Bangaon	India
Bangaon	India
Banganapalle	India
Bengaluru	India
Banga	India
Bandipura	India
Bāndīkūi	India
Bānda	India
Banda	India
Banat	India
Bānapur	India
Bāmor Kalān	India
Bālurghāt	India
Bālugaon	India
Balrāmpur	India
Bālotra	India
Baloda Bāzār	India
Balod	India
Bāli	India
Ballālpur	India
Bāli	India
Balasore	India
Balarāmpur	India
Bālāpur	India
Balāngīr	India
Bālāghāt	India
Bālāchor	India
Bakhtiyārpur	India
Baj Baj	India
Bairāgnia	India
Byndoor	India
Bail-Hongal	India
Baihar	India
Baidyabāti	India
Bahraigh	India
Bahjoi	India
Baheri	India
Baharampur	India
Bahādurgarh	India
Bahādurganj	India
Bāh	India
Bagulā	India
Bāghpat	India
Bāghdogra	India
Bāgha Purāna	India
Bāgepalli	India
Bagasra	India
Bagar	India
Bagalkot	India
Bagaha	India
Bagaha	India
Badvel	India
Badūria	India
Badnāwar	India
Badlapur	India
Bādāmi	India
Badagara	India
Bada Barabīl	India
Bachhraon	India
Babrāla	India
Bābra	India
Babīna	India
Baberu	India
Bābai	India
Azamgarh	India
Ajodhya	India
Ayakudi	India
Avanigadda	India
Avinashi	India
Āvadi	India
Ausa	India
Aurangābād	India
Aurangabad	India
Auraiya	India
Aurād	India
Attur	India
Attingal	India
Attili	India
Atraulī	India
Atmakūr	India
Adirampattinam	India
Athni	India
Āthagarh	India
Atarra	India
Āsind	India
Āsika	India
Asifābād	India
Ashta	India
Ashta	India
Ashoknagar	India
Āsansol	India
Āsandh	India
Ārvi	India
Aruppukkottai	India
Arumuganeri	India
Arukutti	India
Arsikere	India
Āron	India
Arkalgūd	India
Ariyalūr	India
Arcot	India
Arāria	India
Arantāngi	India
Ārani	India
Ārangaon	India
Arang	India
Arāmbāgh	India
Arakkonam	India
Arrah	India
Aonla	India
Anūpshahr	India
Anūppur	India
Anūpgarh	India
Anta	India
Anshing	India
Annur	India
Annigeri	India
Ankleshwar	India
Anjār	India
Anjangaon	India
Anjad	India
Angul	India
Angamāli	India
Anekal	India
Andol	India
Anthiyur	India
Āndippatti	India
Anantnag	India
Anantapur	India
Anandpur	India
Ānand	India
Anakāpalle	India
Anaimalai	India
Amudālavalasa	India
Āmta	India
Amroli	India
Amroha	India
Amritsar	India
Amreli	India
Amrāvati	India
Amod	India
Āmli	India
Āmlāgora	India
Amla	India
Amet	India
Ambur	India
Ambikāpur	India
Ambattūr	India
Ambasamudram	India
Ambāla	India
Ambājogāi	India
Ambāh	India
Ambad	India
Amarpur	India
Amarpātan	India
Amarnāth	India
Amalner	India
Amalāpuram	India
Aluva	India
Alwar	India
Alot	India
Along	India
Alnāvar	India
Almora	India
Alleppey	India
Allahābād	India
Alīpur	India
Alīgarh	India
Alīganj	India
Alībāg	India
Ālangulam	India
Ālangāyam	India
Alandur	India
Alandi	India
Aland	India
Akot	India
Akola	India
Aklera	India
Akivīdu	India
Akbarpur	India
Akbarpur	India
Akaltara	India
Akalkot	India
Ajra	India
Ajnāla	India
Ajmer	India
Aizawl	India
Ahraura	India
Ahmadpur	India
Ahmadnagar	India
Ahmedabad	India
Āgra	India
Agartala	India
Agar	India
Afzalpur	India
Afzalgarh	India
Adūr	India
Adra	India
Ādoni	India
Ādilābād	India
Addanki	India
Achhnera	India
Achalpur	India
Ābu Road	India
Ābu	India
Abohar	India
Abhayāpuri	India
Contai	India
Haldia	India
Srirāmpur	India
Dumjor	India
Bankra	India
Chakapara	India
Mahiari	India
Dhulagari	India
Pānchla	India
Nangi	India
Pujali	India
Monoharpur	India
Nabagrām	India
Soyībug	India
Singāpur	India
Ghatkesar	India
Vijayapura	India
Ādampur	India
Porur	India
Madipakkam	India
Perungudi	India
Madambakkam	India
Powai	India
Navi Mumbai	India
Murudeshwara	India
Shivaji Nagar	India
Greater Noida	India
Mohali	India
Pithampur	India
Barbil	India
Airoli	India
Aluva	India
Kotkapura	India
Muvattupuzha	India
Perumbavoor	India
Vapi	India
Baddi	India
Noida	India
Bhiwadi	India
Mandideep	India
Singrauli	India
Birpara	India
Jaigaon	India
Akkarampalle	India
Bellampalli	India
Chemmumiahpet	India
Gaddi Annaram	India
Dasnapur	India
Kanuru	India
Lal Bahadur Nagar	India
Malkajgiri	India
Mandamarri	India
Chinnachowk	India
Kyathampalle	India
Gajuwaka	India
Manuguru	India
Kalyandurg	India
Ponnur	India
Quthbullapur	India
Ramanayyapeta	India
Palwancha	India
Barpeta Road	India
Sathupalli	India
Yanamalakuduru	India
Marigaon	India
Naharlagun	India
Serilingampalle	India
Silapathar	India
Lumding Railway Colony	India
Aistala	India
Ashoknagar Kalyangarh	India
Bahula	India
Bhawanipur	India
Zira	India
Ramagundam	India
Cherpulassery	India
Kirandul	India
Shiraguppi	India
V.S.K.Valasai (Dindigul-Dist.)	India
Neelankarai	India
Injambakkam	India
Kultali	India
Shahbazpur	India
Kumbalam	India
Aroor	India
Kadakkavoor	India
Kalavoor	India
Kalamassery	India
Cherthala	India
Zaxo	Iraq
Umm Qaşr	Iraq
Tozkhurmato	Iraq
Tikrīt	Iraq
Tallkayf	Iraq
Sīnah	Iraq
Sāmarrā’	Iraq
Nāḩīyat Saddat al Hindīyah	Iraq
Ruwāndiz	Iraq
Rāwah	Iraq
Al-Hamdaniya	Iraq
Mandalī	Iraq
Koysinceq	Iraq
Kifrī	Iraq
Kirkuk	Iraq
Karbala	Iraq
Erbil	Iraq
Hīt	Iraq
Ḩalabjah	Iraq
Ḩadīthah	Iraq
Dihok	Iraq
Jamjamāl	Iraq
Bayjī	Iraq
Baqubah	Iraq
Baynjiwayn	Iraq
Balad	Iraq
Baghdad	Iraq
Az Zubayr	Iraq
Aş Şuwayrah	Iraq
As Sulaymānīyah	Iraq
As Samawah	Iraq
Nāḩiyat ash Shināfīyah	Iraq
Ash Shaţrah	Iraq
Ash Shāmīyah	Iraq
Ar Ruţbah	Iraq
Ar Rumaythah	Iraq
Ramadi	Iraq
‘Aqrah	Iraq
An Nāşirīyah	Iraq
Najaf	Iraq
‘Anat al Qadīmah	Iraq
Imam Qasim	Iraq
Al Musayyib	Iraq
Al Mishkhāb	Iraq
Al Miqdādīyah	Iraq
Al Mawşil al Jadīdah	Iraq
Mosul	Iraq
Al Kūt	Iraq
Kufa	Iraq
Khāliş	Iraq
‘Alī al Gharbī	Iraq
Al Hindīyah	Iraq
Al Ḩillah	Iraq
Al Ḩayy	Iraq
Al Hārithah	Iraq
Nahiyat Ghammas	Iraq
Nāḩiyat al Fuhūd	Iraq
Al Fāw	Iraq
Al Fallūjah	Iraq
Basrah	Iraq
Al ‘Azīzīyah	Iraq
Al ‘Amārah	Iraq
‘Afak	Iraq
Ad Dujayl	Iraq
Ad Dīwānīyah	Iraq
Abū Ghurayb	Iraq
Al Başrah al Qadīmah	Iraq
Sinjār	Iraq
Āzādshahr	Iran
Kahrīz	Iran
Nūrābād	Iran
Īstgāh-e Rāh Āhan-e Garmsār	Iran
Qarchak	Iran
Shahre Jadide Andisheh	Iran
Khorramdarreh	Iran
Yasuj	Iran
Āzādshahr	Iran
Zarand	Iran
Zanjān	Iran
Yazd	Iran
Varāmīn	Iran
Torbat-e Ḩeydarīyeh	Iran
Tonekābon	Iran
Tehran	Iran
Hashtpar	Iran
Tākestān	Iran
Takāb	Iran
Taft	Iran
Tabriz	Iran
Tabas	Iran
Sonqor	Iran
Sirjan	Iran
Shūshtar	Iran
Shūsh	Iran
Shīrvān	Iran
Shiraz	Iran
Shahr-e Kord	Iran
Shahr-e Bābak	Iran
Shādegān	Iran
Semnān	Iran
Semīrom	Iran
Sāveh	Iran
Sari	Iran
Saqqez	Iran
Sanandaj	Iran
Salmās	Iran
Shāhīn Dezh	Iran
Sabzevar	Iran
Rūdsar	Iran
Robāţ Karīm	Iran
Rāvar	Iran
Rasht	Iran
Rāmshīr	Iran
Rāmhormoz	Iran
Rafsanjān	Iran
Qūchān	Iran
Qorveh	Iran
Qom	Iran
Qeshm	Iran
Qazvin	Iran
Qarah Ẕīā’ od Dīn	Iran
Farrokh Shahr	Iran
Qā’en	Iran
Sarpol-e Z̄ahāb	Iran
Pīshvā	Iran
Piranshahr	Iran
Pāveh	Iran
Pārsābād	Iran
Oshnavīyeh	Iran
Orūmīyeh	Iran
Omīdīyeh	Iran
Nūrābād	Iran
Nowshahr	Iran
Nīshābūr	Iran
Neyrīz	Iran
Nekā	Iran
Naz̧arābād	Iran
Naqadeh	Iran
Nahāvand	Iran
Mīnāb	Iran
Mīāndoāb	Iran
Meybod	Iran
Mahrīz	Iran
Masjed Soleymān	Iran
Bardsīr	Iran
Mashhad	Iran
Marand	Iran
Malāyer	Iran
Malārd	Iran
Mahābād	Iran
Langarūd	Iran
Kūhdasht	Iran
Kīsh	Iran
Khvoy	Iran
Khvānsār	Iran
Khorramshahr	Iran
Khorramabad	Iran
Khomeyn	Iran
Khalkhāl	Iran
Kermānshāh	Iran
Kerman	Iran
Kāzerūn	Iran
Kāshmar	Iran
Kāshān	Iran
Karaj	Iran
Kangāvar	Iran
Kāmyārān	Iran
Kalāleh	Iran
Jūybār	Iran
Javānrūd	Iran
Īlām	Iran
Harsīn	Iran
Hamadān	Iran
Gorgān	Iran
Gonbad-e Kāvūs	Iran
Gonābād	Iran
Golpāyegān	Iran
Gerāsh	Iran
Bandar-e Ganāveh	Iran
Fūman	Iran
Fīrūzābād	Iran
Fereydūnkenār	Iran
Fasā	Iran
Fārsān	Iran
Esfarāyen	Iran
Shahrud	Iran
Dogonbadan	Iran
Delījān	Iran
Dehlorān	Iran
Dehdasht	Iran
Sūsangerd	Iran
Darreh Shahr	Iran
Dārāb	Iran
Dāmghān	Iran
Damāvand	Iran
Chenārān	Iran
Chālūs	Iran
Bandar-e Būshehr	Iran
Būkān	Iran
Borūjerd	Iran
Borūjen	Iran
Borāzjān	Iran
Bojnūrd	Iran
Bīrjand	Iran
Bījār	Iran
Bonāb	Iran
Behshahr	Iran
Behbahān	Iran
Bāneh	Iran
Bandar-e Lengeh	Iran
Bandar-e Anzalī	Iran
Bandar ‘Abbās	Iran
Bam	Iran
Bahār	Iran
Bāfq	Iran
Bābolsar	Iran
Bābol	Iran
Aznā	Iran
Hashtrūd	Iran
Āstārā	Iran
Āstāneh-ye Ashrafīyeh	Iran
Asadābād	Iran
Ardestān	Iran
Ardakān	Iran
Ardabīl	Iran
Arāk	Iran
Āmol	Iran
Alvand	Iran
Shahrīār	Iran
Alīgūdarz	Iran
Aleshtar	Iran
Akbarābād	Iran
‘Ajab Shīr	Iran
Ahvaz	Iran
Ahar	Iran
Aghajari	Iran
Ābyek	Iran
Abhar	Iran
Ābdānān	Iran
Ābādeh	Iran
Abadan	Iran
Eqbālīyeh	Iran
Shāhreẕā	Iran
Rehnān	Iran
Qahderījān	Iran
Najafābād	Iran
Khomeynī Shahr	Iran
Kelīshād va Sūdarjān	Iran
Falāvarjān	Iran
Isfahan	Iran
Dowlatābād	Iran
Dorcheh Pīāz	Iran
Zābol	Iran
Zahedan	Iran
Torbat-e Jām	Iran
Tāybād	Iran
Sarakhs	Iran
Qaşr-e Qand	Iran
Khāsh	Iran
Īrānshahr	Iran
Chabahar	Iran
Mahdishahr	Iran
Pasragad Branch	Iran
Akureyri	Iceland
Reykjavík	Iceland
Kópavogur	Iceland
Hafnarfjörður	Iceland
Vittoria	Italy
Villabate	Italy
Vibo Valentia	Italy
Trapani	Italy
Termini Imerese	Italy
Siracusa	Italy
Sinnai	Italy
Siderno	Italy
Sestu	Italy
Selargius	Italy
Scordia	Italy
Scicli	Italy
Sciacca	Italy
San Giovanni la Punta	Italy
San Giovanni in Fiore	Italy
San Cataldo	Italy
Rossano Stazione	Italy
Rosolini	Italy
Ribera	Italy
Reggio Calabria	Italy
Ragusa	Italy
Quattromiglia	Italy
Quartu Sant'Elena	Italy
Pozzallo	Italy
Porto Empedocle	Italy
Piazza Armerina	Italy
Paternò	Italy
Partinico	Italy
Palmi	Italy
Palma di Montechiaro	Italy
Palermo	Italy
Palagonia	Italy
Pachino	Italy
Oristano	Italy
Noto	Italy
Niscemi	Italy
Nicastro-Sambiase	Italy
Monserrato	Italy
Monreale	Italy
Modica	Italy
Misterbianco	Italy
Misilmeri	Italy
Milazzo	Italy
Messina	Italy
Mazara del Vallo	Italy
Mascalucia	Italy
Marsala	Italy
Licata	Italy
Lentini	Italy
Iglesias	Italy
Gioia Tauro	Italy
Giarre	Italy
Gela	Italy
Floridia	Italy
Favara	Italy
Enna	Italy
Crotone	Italy
Cosenza	Italy
Comiso	Italy
Catanzaro	Italy
Catania	Italy
Castrovillari	Italy
Castelvetrano	Italy
Casarano	Italy
Carini	Italy
Carbonia	Italy
Canicattì	Italy
Caltanissetta	Italy
Caltagirone	Italy
Cagliari	Italy
Bronte	Italy
Biancavilla	Italy
Belpasso	Italy
Barcellona Pozzo di Gotto	Italy
Bagheria	Italy
Avola	Italy
Augusta	Italy
Assemini	Italy
Amato	Italy
Alcamo	Italy
Agrigento	Italy
Adrano	Italy
Acireale	Italy
Aci Catena	Italy
Aci Castello	Italy
Zola Predosa	Italy
Voghera	Italy
Vittorio Veneto	Italy
Viterbo	Italy
Vimodrone	Italy
Vimercate	Italy
Lancenigo-Villorba	Italy
Villaricca	Italy
Villafranca di Verona	Italy
Vignola	Italy
Vigevano	Italy
Vicenza	Italy
Viareggio	Italy
Verona	Italy
Vercelli	Italy
Ventimiglia	Italy
Venice	Italy
Venaria Reale	Italy
Velletri	Italy
Vasto	Italy
Varese	Italy
Valenzano	Italy
Valenza	Italy
Valdagno	Italy
Udine	Italy
Triggiano	Italy
Trieste	Italy
Trezzano sul Naviglio	Italy
Treviso	Italy
Treviglio	Italy
Trentola-Ducenta	Italy
Trento	Italy
Trecate	Italy
Trani	Italy
Tradate	Italy
Tortona	Italy
Torremaggiore	Italy
Torre del Greco	Italy
Torre Annunziata	Italy
Turin	Italy
Tolentino	Italy
Tivoli	Italy
Thiene	Italy
Terzigno	Italy
Terracina	Italy
Terni	Italy
Termoli	Italy
Terlizzi	Italy
Teramo	Italy
Taranto	Italy
Suzzara	Italy
Sulmona	Italy
Spoleto	Italy
Sora	Italy
Sondrio	Italy
Somma Vesuviana	Italy
Siena	Italy
Sezze	Italy
Seveso	Italy
Settimo Torinese	Italy
Sestri Levante	Italy
Sesto San Giovanni	Italy
Sesto Fiorentino	Italy
Seriate	Italy
Seregno	Italy
Senigallia	Italy
Senago	Italy
Segrate	Italy
Schio	Italy
Scandicci	Italy
Scafati	Italy
Savona	Italy
Savigliano	Italy
Sava	Italy
Sassuolo	Italy
Sassari	Italy
Sarzana	Italy
Saronno	Italy
Sarno	Italy
San Vito dei Normanni	Italy
Santeramo in Colle	Italy
Sant'Antonio Abate	Italy
Sant'Antimo	Italy
Sant'Anastasia	Italy
Santa Maria Capua Vetere	Italy
San Severo	Italy
San Sebastiano	Italy
San Salvo	Italy
San Remo	Italy
Sannicandro Garganico	Italy
San Miniato	Italy
San Miniato Basso	Italy
San Mauro Torinese	Italy
San Lazzaro	Italy
San Giuseppe Vesuviano	Italy
San Giuliano Milanese	Italy
San Giovanni Valdarno	Italy
San Giovanni Rotondo	Italy
San Giovanni Lupatoto	Italy
San Giovanni in Persiceto	Italy
San Giorgio a Cremano	Italy
San Donato Milanese	Italy
San Donà di Piave	Italy
San Bonifacio	Italy
San Benedetto del Tronto	Italy
Salsomaggiore Terme	Italy
Salerno	Italy
Sacile	Italy
Ruvo di Puglia	Italy
Rutigliano	Italy
Rozzano	Italy
Rovigo	Italy
Rovereto	Italy
Rosignano Solvay-Castiglioncello	Italy
Roseto degli Abruzzi	Italy
Romano di Lombardia	Italy
Rome	Italy
Rocca di Papa	Italy
Rivoli	Italy
Rimini	Italy
Rieti	Italy
Riccione	Italy
Rho	Italy
Reggio nell'Emilia	Italy
Ravenna	Italy
Rapallo	Italy
Qualiano	Italy
Putignano	Italy
Prato	Italy
Pozzuoli	Italy
Potenza	Italy
Porto Torres	Italy
Porto Sant'Elpidio	Italy
Porto San Giorgio	Italy
Portogruaro	Italy
Civitanova Marche	Italy
Portici	Italy
Pordenone	Italy
Pontedera	Italy
Pompei	Italy
Pomigliano d'Arco	Italy
Pomezia	Italy
Poggiomarino	Italy
Poggibonsi	Italy
Pistoia	Italy
Pisa	Italy
Piossasco	Italy
Piombino	Italy
Pioltello	Italy
Pinerolo	Italy
Pietrasanta	Italy
Piacenza	Italy
Pescara	Italy
Pesaro	Italy
Perugia	Italy
Pavia	Italy
Parma	Italy
Parabiago	Italy
Palo del Colle	Italy
Palazzolo sull'Oglio	Italy
Palagiano	Italy
Pagani	Italy
Padova	Italy
Paderno Dugnano	Italy
Ottaviano	Italy
Ostuni	Italy
Osimo	Italy
Orta Nova	Italy
Orbassano	Italy
Olbia	Italy
Oderzo	Italy
Nuoro	Italy
Novi Ligure	Italy
Novate Milanese	Italy
Novara	Italy
Nova Milanese	Italy
Nola	Italy
Noicattaro	Italy
Noci	Italy
Nocera Superiore	Italy
Nocera Inferiore	Italy
Nichelino	Italy
Nettuno	Italy
Nerviano	Italy
Nardò	Italy
Napoli	Italy
Mugnano di Napoli	Italy
Muggiò	Italy
Monza	Italy
Montichiari	Italy
Montevarchi	Italy
Montesilvano Marina	Italy
Monterotondo	Italy
Montemurlo	Italy
Montecchio Maggiore-Alte Ceccato	Italy
Montecatini-Terme	Italy
Montebelluna	Italy
Monopoli	Italy
Monfalcone	Italy
Mondragone	Italy
Mondovì	Italy
Moncalieri	Italy
Molfetta	Italy
Mola di Bari	Italy
Mogliano Veneto	Italy
Modugno	Italy
Modena	Italy
Mirano	Italy
Mirandola	Italy
Mira Taglio	Italy
Minturno	Italy
Milano	Italy
Mestre	Italy
Mesagne	Italy
Merano	Italy
Mentana	Italy
Melzo	Italy
Melito di Napoli	Italy
Melegnano	Italy
Meda	Italy
Matera	Italy
Massafra	Italy
Massa	Italy
Martina Franca	Italy
Marino	Italy
Marina di Carrara	Italy
Marigliano	Italy
Mariano Comense	Italy
Marcianise	Italy
Marano di Napoli	Italy
Mantova	Italy
Manfredonia	Italy
Manduria	Italy
Malnate	Italy
Magenta	Italy
Maddaloni	Italy
Macerata	Italy
Lugo	Italy
Lucera	Italy
Lucca	Italy
Lodi	Italy
Livorno	Italy
Lissone	Italy
Limbiate	Italy
Lido di Ostia	Italy
Lido	Italy
Legnano	Italy
Legnago	Italy
Lecco	Italy
Lecce	Italy
Latina	Italy
La Spezia	Italy
L'Aquila	Italy
Lanciano	Italy
Lainate	Italy
Ladispoli	Italy
Ivrea	Italy
Isernia	Italy